####################
#S                ##
############       #
#            #######
#      ####   #    #
#     #####        #
#### ######        #
#### ######    #   #
#     ###          #
#   ####           #
###              ###
### ###### #########
### #              #
##    #### ## #### #
## ####### ## # ####
#       ## ####    #
# #####  #      ####
# # ################
#                 F#
####################